0000000100111000000000000000000000000000100000000110000100000000011010111111111111111111111111111111
0000000100111000000000001000000000000000000000000000000000000000000010000000001010000000000110111111
0000000101111011101100111000000000000000000000000000000000000000000000000000000010000010011011101111
0000000101010011001110111000000000000000000000000000000000000000000000000000000000000000000001000000
0000001100110011101000110000000010000000000000000000000000111111100000000000000000000000000000000000
0000000101110011101110110000000000000000000000000000000001111111110000000000011111110000000000000000
0000000101110011101100110000000000000000000000000000000011000000011000000000011101111000000000000111
0000001110110011001101110000000000000000000000000000000110000000001100000001101000101100000000011110
0000000100110011001101110000000000000000000000000000001101110001010110000011000000110110000000111010
0000101101110011001100110000000000000000000000000000011101110111010110000011000000001011000001110011
0000100100110011001100100000000000000000000000000000001000110111000011000110000010111011000011000111
0000000111110111001101110000000000000000000000000000011001111111110011000100111010011001100011000111
0000000101110111001101010000000000000000000000000000011001111111011001001100111010111001100011000111
0001011110110010011100010000000000000000000000000000011001110110011001001100111010110000100011000111
0001011101110111011100010000000000000000000000000000010011101111111011001000111010111000100010000011
1000000101110011011101110000000000000000000000000000011011111111111011001000111010111000100010000101
0000011101110111011100110000000000000000000000000000011001100111111111001100111010101001100010000101
0000111100110111011101110000000000000000000000000000011001101111010011001100111010111000100110011100
1000101100100111011101110000000000000111100000000000001101101111010010000100111010011001100111001011
0000001100100111011101100000000000001111111000000000001100100110000110000110000010111001000011000010
0000001100100111011101100000000000001111111000000000000110000000001100000110000000111011000011011111
0000101100100111011001110000000000011011111100000000000011000000011000000011000000000011000001000100
0010001100100111011101110000000000011011101100000000000011111001110000000011100000001100000001101101
0000001100100111011101100000000000011010101100000000000000111111100000000000111001111100000000111101
0000001100100110011001100000000000011011101100000000000000000000000000000000011111110000000000011111
0000001001100111011001100000000000011011111000000000000000000000000000000000000000000000000000001111
0000001001100111011001100000000000001111111000000000000000000000000001000000000000100000000000000010
0000001000100110011001100000000000000111110000000000000000000000000000000000000000000000000000000010
0000001000100110111001100000000000000101110000000000000000000000000000000000000000000000100000000000
0000001010100110111011100000000000000111100000000000000000000000000000000000000000000000000000000000
0100001000100110111011100000000000000011000000010000000000000000000001000000000000000000000000000000
0001001011100100111011100000000010000011000000000000000000000000000000000000000000000000000000000000
0000011011101110111011100000000000000000000000000000000000000000000000000000000000000000000000000000
0000011000101110111011100000000000001111110000000000000000000000000000000000000000000000000000000000
0000011000101110111011100000000000001111110000000000000000000000000000000000000000000000000000000000
0000001000101110010000100000000000011000111000000000000000000000000000000000000000000000000000000000
0001001000101110110011100000000000111111111000000000011111111111111000000010000000000000010000000000
0010001000101110111011100000000000111111111100000000011110011111111100000010000000000000000000000000
1010111001101110101011100000000000110000001100000000010000011000011100000000000000000001000000000000
1000011000001110000011100000000000110000001100000000010100111111101100000000000000000000001000000000
1000011001101110111011100000000000110000001000000000010000000000101100000000000010000000000000000000
0000011001001110111011100000000000110000001000000000010010000000101100000000000010000000000000000000
0001011001001110111001000000000000110000001000000000010010000001111100000000000000000000000000000001
1001011001001110111011000000000000110000001000000000010000110111101100000000000000000000000000000000
0000011001001110111011100000000000110000001000000000010000110111001100000000000000000000000000000000
0000010001001100111011100000000000110000001000000000111000000010011100000000000000000000000000000000
0000010001001110111111000000000000010000001000000000111011001010111100000000000000000000010000000001
0000010011001110110011000000001000011100111000000000111000000010011000000000000000000000010000000000
0000010001001110110011000000000000011101111000000000111000000010011000000000000000000000010000000000
0000010001000110110111000000000001000111110000001111111000000000011000000000000000000000010000000001
0000010001001110110111000000000000000111010000001111110000000000011000000000000000000000000000000001
0000010001001101110111000000000000000111000000000000110000000000011100000000000000000000000000000000
0000010001001001110111000000000000000111000000000000110000000000011100000000000000010000100000000000
0000010001011101110111000000000000000111000000000000110000000000011000000001000000000000100000000000
0000110111011101110111000000000000000111000000010000110000000000011000000000000000000100000000000000
0001110011011101110111000000000000000111000000000000111111111110011000000000000000010000000000000000
0000110001011101110001000000000000000111000000000000110111111111111000000000000000000010000000000000
0000010001011101110110000000000000000111000000000000110100000001101000000000000100000000000000000000
0000010001011001110111000000000000000111000000000000110101000100011000000000000100000000000000000111
0000010011011101100111000000000000000111000000000000110111011110011000000000000000000000000000000111
0000010010011001110111000000000000001111000000000000110001010100011000000000000000000000000000000000
0000110011011101110101000010000000000111000000000000110011001110011000000000000000000000000000000000
0000110011001101110111000000000000000111100000000000110001000000011000000000000000000000000000000110
0000110011000100110110000000000000000111100000000000110000001000011000000000100000000000000000000110
0000110011011101110111000000000000000111000000000000111000010000011000000000100000000000000000100010
0000110010010100110110000000000000000111000000000000111010011000011000000000000000000000000000000100
0000110010011100000111000000000000000111000000000000110011110101010000000000000000000000000000000100
0000101010011101110110000000000000000111000000000000110011011111110000000000000000000000000000000000
0000100110011101110110000000000000000111000000000000111111111100110000000000000000000000010000000000
0000100110011101100110000000011000000111000000000100110010000000110000000000000000000000000000000000
0000100010011001100110000000000000000011100000000000110000000000010000000000000000000000000000000011
0000100010000001111111000100000000000011100000000000110000000000010001000000000000000000000000010011
0000100010000001101110000100000000000011100000000000110000000000110001000000000000000000000000000010
0000100010000001101110000000000000000011100000000000110000000000010000000000000000000000000000000011
0000100010000001101110000000000000000011000000000000110000000000110000000000000000000000000000000011
0000101110000011101011000000000000000011100000000000110000000000110000000000000000000000000010000001
0000101010000011100000000000000000000011100000000000111111011111110000000000000000000001000000000011
0000100010000011100000001000000000000010100000000000000001111111100000000000000000000000000000000011
0001101010000011100000001000000000000010100000000000000001010000000000000000000000000000000000000011
0001100110000011100000000000000000000011110000000000000001011001000000000000000000000000000000000011
0001100100000011100000000001000000000011110000000000000011110001100000010000000000100000000000000011
0001100110000011100000000000000000000001111000000000000011110010000000000000000000100000000000000011
1001100100000011100000000000000000000001111100000000000111100000000000000000000000000000000100000111
1001101100000011100000000000000000000011111110000000011111000000000000000000000000000000000000100011
0111100110000010101000000000000000000000111111100001111111000000000000000000000000000000000000000111
1111100110110011100000010000000000000000011111111111111110000000000000000000000000000000000000000111
1111100100100001100000010000000000000000001111111111111000000000000001000000000000000000000000000011
1101000100000000000000010000000000000000000011111111110000000000000001000000000000100000000000000111
1011001100000001000000010000000000000000000000011100000000000000000000000000000000000000000000000110
0011000100000000000000000000000000000000010000010001000000000000000001000000000000000000000000000111
0011001100000000000000000000000000000000000000010000000000000000000001000010000000000000000000000111
0011000100011000000000000000000000000000000000000000001000000000000000000000000010000100001100000111
0011000100000000000000000000010000000000000000000000001001000000000010000000000000000000001100010111
0011000100000000001000000000010000000000000000000000000000000010010000000000000000000000000000000001
0001111111100000001000000000000000000000000000000000000010000000000000000000000000000000001000000000
0001111111111111111111111110000000000000000000000000000000000000000000000000000000000000001000000111
0011111111111111111111111111111111111111010000000000000000000000000000000000000000000000000000010111
0101101011011010011111111111111111111111111111111111100000000000000000000000000000000000000000000000
0101100100011010010110111111111111111011111111111111111111111111100000000000000000000000000000000000
0101100101111000010010010011110101111011110111101111111111111111111111111111111111011100000000000000
