0000000000000000000000000000000000000000000000000000000000000000000000000000000000000000000000000000
0000000000000000000000000000000000000000000000000000000000000000000000000000000000000000000000000000
0000000000000000000000000000000000000000000000000000000000000000000000000000000000000000000000000000
0000000000000000000000000000000000000000000000000000000000000000000000000000000000000000000000000000
0000000000000000000000000000000000000000000000000000000000000000000000000000101100000000000000000000
0000000000000000000000000000000000000000000000000000000000000000000000000111100000000000000000000000
0000000000000000000000000000000000000000000000000000000000000000000000000110000000000001100000000000
0000000000000000000000000000000000000000000000000000000000000000000000010000000000000000000000000000
0000000000000000000000000000000000000000000000000000000000000000000000110000000000000000000000000000
0000000000000000000000000000000000000000000000000000000000000000010001100100000000000000000000000000
0000000000000000000000000000000000000000000000000000000000000000010001100110001000000000000000000000
0000000000000000000000000000000000000000000000000000000000000000010000100111111000000000000001000000
0000000000000000000000000000000000000000000111111111000000000000010000100111000000000000000001000000
0000000000000000000000000010000000000001111111100000000000000000010000010110000000000000110001000000
0000000000000000100000000110000000000000000000000000000000000000010000010110000000000000000001000000
0000000000000000100000000100000000000000000000000000000000000000010000011111000000000000000001000010
0000000000000000100000000100000000000000000000000000000000000000011000001010000000000000000001000010
0000000000000000100000000100000000000000000000000000000000000001110000000010000000000000000001101100
0000000000000000110000000100000000000000000000000000000000000111000000000010000000000000000000100001
0000000000000000110000000100000000000000000000000000000000011110000000000010000000000000000000100000
0000000000000000110000000111000000000000000000000000000001111000000000000010000000000000100000100000
0000000000000000110000000111110000000000000000000000000011100000000000000011000000000000000000100000
0000000000000000010000000000111110000000000000000000011110000000000000000010000000000000000000100010
0000000000000000011000000000000111110000000000000000111000000000000000000010000000000000000000100010
0000000000000000001100000000000000111110000000000011100000000000000000000010000000000000000000100000
0000000000000000000111000000000000000011110000000110000000000000000000000010000000000000010000100000
0000000000000000000011100000000000000000110000000100000000000000000000000010000000000000000000100000
0000000000000000000001110000000000000000010000000100000000000000000000000010000000000000000000100000
0000000000000000000000010000000000000000010000000100000000000000000000000010000000000000000000100000
0000000000000000000000011000000000000000010000000100000000000000000000000010000000000000000000100000
0000000000000000000000001100000000000000010000000100000000000000001001111110000000010000000000100000
0000000000000010000000000100000000000000010000000100000000001111111111111110000000000000000000110000
0000000000000010000000000000000000100000010000000100000000000000000000000000000000000000000000010000
0000000000000010000000000000000000100000010000000100000000000000000000000000000000000100000000010000
0000000000000011000000000000000000100000010000000100000000000000000000000000000000000000000000010000
0000000000000001000000000000000000100000011000000110000000000000000000000000000000000000000000010000
0000000000000001000000000000000000100000011000000110000000000000000000000000000000000000000000010000
0000000000000001000000000000000000100000001000000010000000000000000000000000000000000000000000010000
0000000000000001000000000000000000100000000000000000000000000000000000000000000010000000000000010000
0000000000000001000000000000000000100000000000000000000000000000111111111110000010000000100000010000
0000000000000001000000000000000000100000000000000000000000000000100000000111000010000000100000010000
0000000000000001000000000000000000110000000000000000000000000000100000000001100010000000101111110000
0000000000000001000000000000000000110000000000000000000000000000100000000000111010000000111111110000
0000000000000001000000000000000000100000000000000000000000000001100000000000011110000000000000010000
0000000000000001000000000000000000100000000000000111111000000111100000000000001110000000000000010000
0000000000000001000000000011111111110000011111111111111000011110000000000000000000000000000000010000
0000000000000001000000000001110100000000000000000000000001111000000000000000000000000000000000010000
0000000000000001000000000000000000000000000000000000000011100000000000000000000000000000000000010000
0000000000000001100000000000000000000000000000000000000110000000000000000000000000000000000000010000
0000000000000001100000000000000000000000000000000000001100000000000000000000000000000000000000010000
0000000000000001100000000000000000000000000000000000011000000000000000000000000000000000000000010000
0000000000000001100000000000000000000000000000000001110000000000000000000000000000000000000000010000
0000000000000001100000000000001100000000000000000011100000000000000000000000000000000000000000010000
0000000000000001100000000000011000000000000000001110000000000000000000000000000000000000000000010000
0000000000000000111111111111110000000000000000011100000000000000000000000000000000000000000000010000
0000000000000000100000000000000000000000000000110000000000000000000000000000000000000000000000010000
0000000000000000100000000000000000000000000011100000000000000000000000000000000000000000000000010000
0000000000000000100000000000000000000000001111000000000000000000000000000000000000000000000000010000
0000000000000000100000000000000000000000011100000000000000000000000000000000000000000000000000010000
0000000000000000100000000100000000000001111000000000000000000000000000000000000000000000000000010000
0000000000000000100000000110000000000011100000000000000000000000000000000000000000000000000000010000
0000000000000000100000000011000000000111000000000000000000000000000000000000000000000000000000010000
0000000000000000100000000001100000001110000000000000000000000000000000000000000000000000000000010000
0000000000000000110000000000110000011100000000000000000000000000000000000000000000000000000000010000
0000000000000000110000000000010000010000000000000000000000000000000000000000000000000000000000010000
0000000000000000110000000000011111111000000000000000110000000000000000000000000000000000000000010000
0000000000000000110000000000001111111111111111111111111111100000000000000000000000000000000000010000
0000000000000000110000000000000000000000000000000101100000000000000000000000011111111111111111110000
0000000000000000110000000000000000000000000000000001000000000000000000000000011110000110000000010000
0000000000000000010000000000000000000000000000000001000000000000000000000000010000000000000000010000
0000000000000000010000000000000000000000000000000011000000000000000000000000010000000000000000010000
0000000000000000010000000000000000000000000000000011000000000000000000000000010000000000000000010000
0000000000000000010000000000011111111100000000000001000000000000000000000000010000000000000000010000
0000000000000000010000000111111100111110000000000001000000000000000000000000010000000000000000010000
0000000000000000011000011111000000000110000000000001000000000000000000000000010000000000000000010000
0000000000000000001001111000111100000010000000000001000000000000000000000000010000000000000000010000
0000000000000000001011111111111111000010000000000001000000000000000000000000010000000000000000010000
0000000000000000001111111100000001100010000000000001000000000000000000000000010000000000000000010000
0000000000000000001111100000000001100110000000000001111111100000000000000000010000000000000000010000
0000000000000000011110000000000001000110000000000000000011111111111111100000010000000000000000010000
0000000000000000111100000000000011001100000000000000000000000000001111100000010000000000000000010000
0000000000000001111000000000000111011000000000000000000000000000000000000000110000000000000000010000
1000000000000011110000000000001110110000000000000000000000000000000000000000110000000000000000010000
1000000000000111100000000110011101100000000000000000000000000000000000000000110000000000000000010000
1000000000000111000000000111111111000000000000000000000000000000000000000000110000000000000000010000
1000000000000001000000001101111110000000000000000000000000000000000000000111110000000000000000010000
1000000000000001000000001100111000000000000000000000000000000000000001111110110000000000000000010000
1000000000000001000000011000111001000000000000000000000000000000001111100000100000000000000000010000
1000000000000001100001111100111111100000000000000000000000000001111100000000100000000000000000110000
1000000000000011110000000100101111000000000000000000000000111111000000000000100000000000000000110000
1000000000000011111111000100101111000000000000000000000111110000000000000000100000000000000000010000
1000000000000000000011111111101111100000000000000011111110000000000000000000100000000000000000110000
1000000000000000000000111111111111101111110000011111100000000000000000000000100000000000000000100000
1000000000000000000000000000000111111101111111111000000000000000000000000000100000000000000000100000
1000000000000000000000000000000000001111111111111111000000000000000000000000100000000000000000100000
1000000000000000000000000000000000000000000111000011111111100000000000000000110000000000000000100000
1000000000000000000000000000000000000000000000000000000011111111111111111000010000000000000000100000
1000000000000000000000000000000000000000000000000000000000000000000011111111111000000000000000100000
1000000000000000000000000000000000000000000000000000000000000000000000000001111111111111000000100000
1000000000000000000000000000000000000000000000000000000000000000000000000000010000000111111111100000
