1110000000000000000000000000000000000000000000000000000000000000000000000000000000000000000000000000
1110000000000000000000000000000000000000000000000000000000000000000000000000000000000000000000000000
0110000000000000000000000000000000000000000000000000000000000000000000000000000000000000000000000000
1110000000000000000000000000000000000000000000010000100000000000000000000000000000000000000000000000
1110000000000000000000000000111100000000000000000000000000000000000000000000000000000000000000000000
0110000000000000000000000111111111111110000000000000000000000000000000000000000000000000000000000000
0110000000000000000000001111000000001111111110000000000000000000000000000000000000000000000000000000
1100000000000000000000011100000000000000001111110000000000000000000000000000000000000000000000000000
1100000000000000000000111000000000000000000000111110000000000000000000000000000000000000000000000000
1100000000000000000001100000000000000000000000000111111000000000000000000000000000000000000000000000
1100000000000000000011000000000000000000000000000000111110000000000000000000000000000000000000000000
1100000000000000000110000000000000000000000000000000000011110000000000000000000000000000000000000000
1100000000000000001100000000000000000000000000000000000000111000000000000000000000000000000000000000
1100000000000000011000000000000000000000000000000000000000001110000000000000000000000000000000000000
1100000000000000110000000000000000000000000000000000000000000011000000000000000000000000000000000000
1100000000000000110000000000000000000000000000000000000000000001110000000000000000000000000000000000
1100000000000001100000000000000000000000000000000000000000000000111000000000000000000000000000000000
1100000000000001000000000000000000000000000000000000000000000000001100000000000000000000000000000000
1000000000000011000000000000000111000000000000000000111111000000000110000000000000000000000000000000
1000000000000010000000000000011111111000000000000011110111110000000011000000000000000000000000000000
1000000000000110000000000000111110011000000000000011000000011000000001100000000000000000000000000000
1000000000000100000000000001100000001100000000000111000000001000000000110000000000000000000000000000
1000000000001100000000000001000000000100000000000100000000001000000000011000000000000000000000000000
1000000000001100000000000001000000001100000000000100000000001000000000001100000000000000000000000000
1000000000001000000000000001000000001100000000000110000000001000000000000100000000000000000000000000
1000000000001000000000000111001000001100000000000010000000001000000000000110000000000000000000000000
1000000000011000001110000111001000001000000000000010000000011000000000000011000000000000000000000000
1000000000010000000000000001000000001000000000000011000000010000000000000001000000000000000000000000
1000000000010000000000000001100000001000000000000001000000110000000000000001100000000000000000000000
1000000000010000000000000000100000001000000000000001100011100000000000000000100000000000000000000000
1000000000010000000000000000110000011000000000000000111111000000000000000000100000000000000000000000
1000000000010000000000000000011100110000000000000000000000000000000000000000110000000000000000000000
0000000000100000000000000000000111100000000000000000000000000000000000000000010000000000000000000000
1000000000100000000000000000000000000000000001000000000000000000000000000000011000000000000000000000
1000000000100000000000000000000000000000000011000000000000000000000000000000011000000000000000000000
0000000000100000000000000000000000000000000011100000000000000000000000000000001000000000000000000000
0000000000100000000000000000000000000000000110111000000000000000000000000000001100000000000000000000
0000000000100000000000000000000000000000000100011000000000000000000000000000000100000000000000000000
0000000000100000000000000000000000000000001100001100000000000000000000000000000100000000000000000000
0000000000100000000000000000000000000000001000000110000000000000000000000000000100000000000000000000
0000000000100000000000000000000000000000011000000110000000000000000000000000000100000000000000000000
0000000000100000000000000000000000000000010000111110000000000000000000000000000110000000000000000000
0000000000100000000000000000000000000000111111110000000000000000100000000000000110000000000000000000
0000000000100000000000000000000000000000111100000000000000000000110000000000000010000000000000000000
0000000000100000000000000000100000000000000000000000000000000000110000000000000010000000000000000000
0000000000100000000000000001100000000000000000000000000000000000100000000000000010000000000000000000
0000000000100000000000000000000000000000000000000000000000000000100000000000000010000000000000000000
0000000000100000000000000000000000000000000000000000000000000000100000000000000011000000000000000000
0000000000100000000000000000000000000000000000000000000000000001100000000000000001000000000000000000
0000000000100000000000000000000000000000000000000000000000000001000000000000000001000000000000000000
0000000000100000000000000100000000000000000000000000000000000001000000000000000001000000000000000000
0000000000100000000000000110000000000000000000000000000000000011000000000000000001000000000000000000
0000000000100000000000000010000000000000000000000000000000000010000000000000000011000000000000000000
0000000000100000000000000011000000000000000000000000000000000110000000000000000010000000000000000000
0000000000100000000000000001100000000000000000000000000000001100000000000000000010000000000000000000
0000000000110000000000000000110000000000000000000000000000001000000000000000000110000000000000000000
0000000000110000000000000000011100000000000000000000000000011000000000000000000110000000000000000000
0000000000010000000000000000000110000000000000000000000000110000000000000000000100000000000000000000
0000000000010000000000000000000011100000000000000000000011100000000000000000001100000000000000000000
0000000000011000000000000000000000111000000000000000000111000000000000000000001000000000000000000000
0000000000011000000000000000000000001111000000000000011100000000000000000000001000000000000000000000
0000000000001000000000000000000000000011111100001111110000000000000000000000011000000000000000000000
0000000000001000000000000000000000000000011111111110000000000000000000000000110000000000000000000000
0000000000001100000000000000000000000000000000000000000000000000000000000000100000000000000000000000
0000000000000100000000000000000000000000000000000000000000000000000000000001100000000000000000000000
0000000000000110000000000000000000000000000000000000000000000000000000000011000000000000000000000000
0000000000000110000000000000000000000000000000000000000000000000000000000110000000000000000000000000
0000000000000011000000000000000000000000000000000000000000000000000000001110000000000000000000000000
0000000000000001000000000000000000000000000000000000000000000000000000011000000000000000000000000000
0000000000000001100000000000000000000000000000000000000000000000000000110000000000000000000000000000
0000000000000000110000000000000000000000000000000000000000000000000001100000000000000000000000000000
0000000000000000011100000000000000000000000000000000000000000000000111000000000000000000000000000000
0000000000000000000110000000000000000000000000000000000000000000011100000000000000000000000000000000
0000000000000000000011100000000000000000000000000000000000000000111000000000000000000000000000000000
0000000000000000000000111000000000000000000000000000000000000111100000000000000000000000000000000000
0000000000000000000000001110000000000000000000000000000000111110000000000000000000000000000000000000
0000000000000000000000000011110000000000000000000000000111110000000000000000000000000000000000000000
0000000000000000000000000000111111000000000000000001111110000000000000000000000000000000000000000000
0000000000000000000000000000000011111111111111111111100000000000000000000000000000000000000000000000
0000000000000000000000000000000000000111111111100000000000000000000000000000000000000000000000000000
0000000000000000000000000000000000000000000000000000000000000000000000000000000000000000000000000000
0000000000000000000000000000000000000000000000000000000000000000000000000000000000000000000000000000
0000000000000000000000000000000000000000000000000000000000000000000000000000000000000000000000000000
0000000000000000000000000000000000000000000000000000000000000000000000000000000000000000000000000000
0000000000000000000000000000000000000000000000000000000000000000000000000000000000000000000000000000
0000000000000000000000000000000000000000000000000000000000000000000000000000000000000000000000000000
0000000000000000000000000000000000000000000000000000000000000000000000000000000000000000000000000000
0000000000000000000000000000000000000000000000000000000000000000000000000000000000000000000000000000
0000000000000000000000000000000000000000000000000000000000000000000000000000000000000000000000000000
0000000000000000000000000000000000000000000000000000000000000000000000000000000000000000000000000000
0000000000000000000000000000000000000000000000000000000000000000000000000000000000000000000000000000
0000000000000000000000000000000000000000000000000000000000000000000000000000000000000000000000000000
0000000000000000000000000000000000000000000000000000000000000000000011000000000000000000000000000000
0000000000000000000000000000000000000000000000000000000000000000000000000000000000000000000000000000
0000000000000000000000000000000000000000000000000000000000000000000000000000000000000000000000000000
0000000000000000000000000000000000000000000000000000000000000000000000000000000000000000000000000000
0000000000000000000000000000000000000000000000000000000000000000000000000000000000000000000000000000
0000000000000000000000000000000000000000000000000000000000000000000000000000000000000000000000000000
0000000000000000000000000000000000000000000000000000000000000000000000000000000000000000000000000000
0000000000000000000000000000000000000000000000000000000000000000000000000000000000000000000000000000
