0000000000000000000111111l00000000000000000000000000000000000000000000000000000000000000000000000000
000000000000000111100000o111000000000000000000000000000000000000000000000000000000000000000000000000
0000000000000011000000000001110000000000000000000000000000000000000000000000000000000000000000000000
0000000000000110000000000000111000000000000000000000000000000000000000000000000000000000000000000000
0000000000001100000000000000011000000000000000000000000000000000000000000000000000000000000000000000
0000000000011000000000000000001110000000000000000000000000000000000000000000000000000000000000000000
0000000000110000000000000000000110000000000000000000000000000000000000000000000000000000000000000000
0000000000100000000000000000000011000000000000000000000000000000000000000000000000000000000000000000
0000000001100000000000000000000011000000000000000000000000000000000000000000000000000000000000000000
0000000001000000000000000000000001000000000000000000000000000000000000000000000000000000000000000000
0000000001000000000000000000000001100000000000000000000000000000000000000000000000000000000000000000
0000000011000000000000000000000000100000000000001100000000000000000000000000000000000000000000000000
0000000110000000000000000000000001100001001111111100000000000000000000000000000000000000000000000000
0000000100000000000000000000000001000001001100000000000000000000000000000000000000000000000000000000
0000001100000000000000000000000001000001001000000000000000000000000000000000000000000000000000000000
0000001100000000000000000000000001000001001000000000000000000000000000000000000000000000000000000000
0000001000000000000000000000000011100001001100000000000000000000000000000000000000000000000000000000
0000001000000111110000000000000011100001001100000000000000000000000000000000000000000000000000000000
0000010000000110111000000000000111110001000100111111100000000000000000000000000000000000000000000000
0000010000001100001000000010000101011001000111110000000000000000000000000000000000000000000000000000
0000010000001000001000000011101101101101100100000000000000000000000000000000000000000000000000000000
0000010000011000001000000000111000101100100110000000000000000000000000000000000000000000000000000000
0000110000110000011000000000010000100110100010000000000000000000000000000000000000000000000000000000
0000110000100000010000000000011000100011100010001111110000000000000000000000000000000000000000000111
0000100001100000110000011000001000100001100011111100000000000000000000000000000000000000000000001111
0000100011000000110000111100001000110001111111111111111000000000000000000000000000000000000000011011
0000100011000000110000100100001000011111111000000000011111000000000000000000000000000000000000111111
0000100110000000100000100100001011111000000000000000000011100000000000000000000000000000000000111100
0000101100000000110000111100011111000000000000000000000000111000000000000000000000000000000000111000
0000101100000000110000111000011100000000000000000000000000001100000000000000000000000000000000011111
0000111000000000010000000000010000000000000000000000000000000110000000000000000000000000000000011111
0000111000000000011000000000000000000000000000000000000000000011100000000000000000000000000000111111
0000010000000000011000000000000000000000000000000000000000000000110000000000000000000000000111111110
0000000000000000001100000000000000000011111111111111110000000000011000000000000000000000001100011010
0000000000000000001111000000000000111111111100000000111100000000001100000000000000000000001010011011
0000000000000000011011100000000011110000001100000000001110000000001100000000000000000000001010110010
0000000000000000010111000000011110000000001100000000000011000000000100000000000000000000001110000110
0000000000000000011110000000111000000000001100000000000001100000000010000000000000000000001110101100
0000000000000000111110000001100000000000001111111100000000110000000010000000000000000000000111111100
0000000000000000110100000011000000000000001111111111000000011000000010000000000000000000000111111111
0000000000000000000100000110000000000000000000000001110000001000000011000000000000000000000001100111
0000000000000000001100000100000000000000000000000000011000001100000001000000000000000000000000001111
0000000000000000001000001100000000100000000000000000001100000100000001000000000000000000000000111111
0000000000000000001000001000000001100000000000000000000110000110000001000000000000000000000111111111
0000000000000000001000001000000011000000000000000000000010000110000001100000000000000000001110111000
0000000000000000001000001000000110000000000000000000000011000010000000100000000000000000011110001000
0000000000000000001000001000000100000000000000000000000001000011000000100000000000000000001110001000
0000000000000000001000001000001100000000001111111000000001100001000000110000000000000000001000011000
0000000000000000001001111000001000000000111000001110000000100001000000010000000000000000001111111000
0000000000000000001111110000001000000001100000000110000000100001000000010000000000000000001111111111
0000000000000000001000000000001000000001100000001111000000110111100000010000000000000000000111111111
0000000000000000001000000000001000000011000000001111000000111110000000010000000000000000000000000000
0000000000000000001000000000001000000010000000000001000000010000000000010000000000000000000000000000
0000000000000000001000000000001000000010000000000001000000100000000000010000000000000000000000000000
0000000000000000001000000000001000000010000000000001000000100000000000010000000000000000000000000000
0000000000000000001000001000001000000110000000000011000000100000000000010000000000000000000000010000
0000000000000000001000001000001000000110000000000010000000100000000000010000000000000000000011111111
0000000000000000001100001000001100000110000000000010000001100000000000110000000000000000000111001101
0000000000000000000100001000000100000011000000000110000001000000000000110000000000000000000111011000
0000000000000000000100001100000110000011000000000100000001000001111000100000000000000000000111000000
0000000000000000000100001100000010000001000000001100000011000001111111100000000000000000000011000100
0000000000000000000100000100000011000001110000011000000011000001000001100000000000000000000011111000
0000000000000000000110000100000001100000011100000000000010000001000001000000000000000000000001111100
0000000000000000000010000110000000100000001100000000000110000001000001000000000000000000000000001111
0000000000000000000010000010000000000000011000000000000100000001000011000000000000000000000000000011
0000000000000000000010000010000000000000010000000000001100000001000010000000000000000000000000000000
0000000000000000000010000010000000000000110000000000011000000011000010000000000000000000000000000000
0000000000000000000011000011000000000000100000000000011000000010000010000000000000000000000000000000
0000000000000000000001000001000000000000100000000001110000000010000010000000000000000000000000000000
0000000000000000000001000001100000000000111111111111000000000110000110000000000000000000000000000000
0000000000000000000001000000100000000000001111110000000000000100000100000000000000000000000000000000
0000000000000000000001100000110000000000000000000000000000001100000100000000000000000000000000000000
0000000000000000000000100000011000000000000000000000000000001000000100000000000000000000000000000000
0000000000000000000000100000001100000000000000000000000000011000001100000000000000000000000000000000
0000000000000000000000110000000110000000000000000000000000110000001000000000000000000000000000000000
0000000000000000000000010000000011100000000000000000000001100000011000000000000000000000000000000000
0000000000000000000000010000000000111100000000000000001111000000010000000000000000000000000000000000
0000000000000000000000011000000000001111111111111111111100000001110000000000000000000000000000000000
0000000000000000000000001100000000000000001001111111000000000011100000000000000000000000000000000000
0000000000000000000000000110000000000000000000000000000000000111000000000000000000000000000000000000
0000000000000000000000000011000000000000000000000000000000001110000000000000000000000000000000000000
0000000000000000000000000001100000000000000000000000000000011100000000000000000000000000000000000000
0000000000000000000000000001110000000000000000000000000000110000000000000000000000000000000000000000
0000000000000000000000000000011000000000000000000000000111100000000000000000000000000000000000000000
0000000000000000000000000000001110000000000000000000011110000000000000000000000000000000000000000000
0000000000000000000000000000000011100000000000000111111000000000000000000000000000000000000000000000
0000000000000000000000000000000000111111100001111110000000000000000000000000000000000000000000000000
0000000000000000000000000000000000000011111111110000000000000000000000000000000000000000000000000000
0000000000000000000000000000000000000000000000000000000000000000000000000000000000000000000000000000
0000000000000000000000000000000000000000000000000000000000000000000000000000000000000000000000000000
0000000000000000000000000000000000000000000000000000000000000000000000000000000000000000000000000000
0000000000000000000000000000000000000000000000000000000000000000000000000000000000000000000000000000
0000000000000000000000000000000000000000000000000000000000000000000000000000000000000000000000000000
0000000000000000000000000000000000000000000000000000000000000000000000000000000000000000000000000000
0000000000000000000000000000000000000000000000000000000000000000000000000000000000000000000000000000
0000000000000000000000000000000000000000000000000000000000000000000000000000000000000000000000000000
0000000000000000000000000000000000000000000000000000000000000000000000000000000000000000000000000000
0000000000000000000000000000000000000000000000000000000000000000000000000000000000000000000000000000
0000000000000000000000000000000000000000000000000000000000000000000000000000000000000000000000000000
0000000000000000000000000000000000000000000000000000000000000000000000000000000000000000000000000000
